NO ./textures/north.xpm
SO ./textures/south.xpm
WE ./textures/west.xpm
EA ./textures/east.xpm

F 220,100,0
C 225,30,0

111111
100101                  111111
100001111111111111111111100011
111111               1110000011111
                       111111111
                         11011
111111                 111110111
100001                     1111
101001
110001
111111

14
15
