SO ./textures/south.xpm
WE ./textures/west.xpm
EA ./textures/east.xpm
NO ./textures/north.xpm
F 220,100,0
C 225,30,0

111111111111
110000100001
111111111111
11110111N111
111111111111